##########
#........#
#.######.#
#.#...G#.#
#.#..###.#
#.#....#.#
#.###.#.##
#...#.#..#
#.###.#S.#
#........#
##########