################
##^^^^^^^^^#####
#^^#######^^^^^#
#S############G#
#.^#######^^^^.#
#..^^^###^.....#
#^...^#^^..^^^##
##^^......^#####
###^^^^^^^######
################