####################
#S#...#...#........#
#.#.#.###.#.#.#.####
#...#.....#.#.#.#.##
#.#####.#.#.###.#.##
#...#...#.#...#.#.##
#.#.#.#####.#####.##
#.#.#.#.......#.#..#
###.###########.####
#...#.......#.....##
###.#.###.###.######
#.......#.........##
#.#.#####.###.###.##
#.#...#...#.....#..#
###.#.#.#.##########
#...###.#.#.#.....##
#.###.###.#.#.###.##
#.#.#...#...#.#.#..#
#.#.#######.###..G.#
####################
