####################
#....#########.....#
#..#...........#.#.#
#..#.#########.#.#.#
#..#...........#.#.#
#..#.#######.#.#.#.#
#..#.#.......#.#.#.#
#..#.#.#####.#.#.#.#
#..#.#.#...#.#.#.#.#
#..#.#.#.G.#.#.#.#.#
#..#.#.#...#.#.#.#.#
#..#.#.#.###.#.#.#.#
#..#.#.......#.#.#.#
#..#.##.######.#.#.#
#..#...........#.#.#
#..###.#########.#.#
#................#.#
#.####.###########.#
#.................S#
####################