####################
#..................#
#..................#
#..................#
#..................#
#....#######.#.....#
#....#.......#.....#
#....#.#####.#.....#
#....#.#...#.#.....#
#....#.#.G.#.#.....#
#....#.#...#.#.....#
#....#.#.###.#.....#
#....#.......#.....#
#....#..######.....#
#..................#
#..................#
#..................#
#..................#
#.................S#
####################