####################
#..................#
#.################.#
#.#................#
#.#.################
#.#................#
#.################.#
#.##...............#
#.##.###############
#..#...............#
#S.###############G#
##.###############.#
##.#...#...#...###.#
##.#.#.#.#.#.#.#...#
##...#.#.#.#.#.#.###
######...#...#...###
####################
####################
####################
####################