#####################
#S###################
#...................#
#.######.#######.####
#...................#
#.########.######.###
#...................#
#.#################.#
#...................#
#######.###########.#
#...................#
#############.#######
#...................#
####.######.#########
#...................#
#.#####.########.####
#...................#
#####.##########.##.#
#...................#
############G########
#####################