S.###################
......#.....#.......#
#.#######.#######.###
#.#.#.#.....#.#.....#
#.#.#.#####.#.#####.#
#.......#.#.#.#.....#
#.#######.#.#.###.#.#
#.....#.#.#...#.#.#.#
#.#####.#.#.#.#.###.#
#.#...#.#...#.#.....#
#.###.#.###.#####.#.#
#.......#.......#.#.#
#.#############.#.###
#...#...#.#.#.......#
#.#####.#.#.#.###.#.#
#...............#.#.#
#.###.#.###########.#
#...#.#.#.........#.#
###.#######.#####.#.#
#.....#.........#...#
###################.G