S.#################################################
......#.......#.......#.......#.........#.........#
#.#####.#####.#.#####.#####.#######.###.#####.#####
#.....#.#.#.....#.#.#.#...........#.#.#.....#.....#
#.#.###.#.###.#.#.#.#.#.#.#.#.#.###.#.#######.###.#
#.#.......#...#.....#.#.#.#.#.#.....#.#.........#.#
###.#.#.###.#.###.#.#####.###.#.#####.#####.###.###
#...#.#.#...#.#...#...#.....#.#.#.....#.#...#.....#
#.###.#####.#####.#.#.###.#.#######.###.#######.#.#
#...#...#.#...#...#.#.#.#.#.....#...#.#...#.....#.#
#.###.###.#######.#####.#.#####.#.#.#.###.#######.#
#...#.....#...............#.....#.#.....#...#.#...#
#.#.#####.#####.#####.###########.#.#######.#.#.###
#.#.#...#...#...#.#.#.#.#.....#...#.#.#.#.#.#.#...#
#.#.#.#.#########.#.###.#####.#.#####.#.#.#.#.#.###
#.#...#.....#.....#.#.......#.......#...#.....#...#
#.#####.#.###.#####.#####.#####.#.###.#.#.###.#.#.#
#...#...#.#.#.#...#.#...#.....#.#.#...#.....#...#.#
#####.#####.#.###.#.###.#.#####.#####.###.#####.###
#...............#.....#.#...........#.#...#...#.#.#
###.#.#########.###.###.#.###.#####.###.###.###.#.#
#...#.#...#.#.......#.#.....#.#...#.#.#.#...#.#...#
###.#####.#.#.#.#.###.#.#####.###.#.#.###.#.#.###.#
#.#...#.#.....#.#.#.......#.....#...#.#...#.......#
#.###.#.#####.#######.#####.#.###.###.#.#####.###.#
#.......#...#.#.#...#.#.#.#.#...#.#.#.#.....#...#.#
#######.#.#####.###.#.#.#.#.#.#####.#.###.#.###.###
#...#...#.#.........#...#...#.#.........#.#.#.....#
#.#####.#.#.###.#############.#.#####.#####.###.###
#.#.#.#.#.....#.......#...........#...#.......#...#
#.#.#.#.#.#######.###.#######.#.#####.###.#.#.#.###
#.#.#.#.....#.......#...#.....#.#...#...#.#.#.#...#
#.#.#.#.#########.#.#######.#######.#.#######.#####
#.......#...#.....#.............#.......#...#...#.#
#.#.#.###.###################.#.###########.#.#.#.#
#.#.#.#.#.......#.....#.#...#.#...#.......#...#...#
#.#.###.#####.###.#####.###.###.#.#####.#.###.#####
#.#.................#.....#.....#...#...#.....#...#
###.#.###.#.#######.###.#######.###.#########.#.###
#.#.#.#.#.#.......#.......#...#.#.#.......#.#.....#
#.###.#.###.###.###.#.#.###.###.#.#.#.#.#.#.#.#####
#...#.#...#.#...#.#.#.#...#...#.#...#.#.#.#.......#
###.#.#.#.#.###.#.#.###.#.#.#######.###.###.###.###
#.#...#.#...#.#.#.#.#...#...#...#.....#.#.#.#.#...#
#.#.#######.#.###.#######.#.#.#######.###.###.#.#.#
#...#...#.#.....#...#.#...#...#...#.........#...#.#
#.#.#.###.#######.###.#.#.###.#.#.###.###.###.#####
#.#.....#.#.........#.#.#.#.#...#.#.#.#.#.#...#...#
#.#.###.#.###.#######.###.#.###.###.###.#.#.#.#.#.#
#.#...#.............#.........#...#.........#...#.#
#################################################.G